NO ./textures/north.xpm
SO ./textures/south.xpm
WE ./textures/west.xpm
EA ./textures/east.xpm

F 220,100,0
C 225,30,0

111111111111111
100000000000001
101111011111101
10N000000000001
101011111110101
100000000000001
111111111111111
